0,1,0,0,0,0,1,2,0,0,0,0,0,0,0,0,0,0,1,1,0,0,0,5
1,2,1,0,1,0,0,0,4,0,4,6,0,0,0,0,0,0,0,1,1,2,1,0
0,0,4,0,0,0,0,0,0,3,0,0,0,0,0,1,0,1,0,0,1,0,0,0
0,0,0,0,0,0,0,0,0,0,0,0,0,1,1,0,1,0,0,1,4,0,0,0
0,0,1,1,1,0,0,1,0,0,0,5,0,0,0,1,0,1,0,0,0,0,0,1
1,0,0,0,0,0,0,0,3,0,0,1,1,0,0,1,0,1,0,1,0,0,1,1
0,0,1,0,0,1,1,0,0,0,0,0,0,4,0,0,0,1,0,1,0,1,1,1
0,1,0,0,1,0,0,1,1,1,2,0,0,6,0,0,6,0,0,5,0,0,0,0
0,1,0,0,1,0,0,0,0,0,0,0,1,0,0,0,0,2,0,1,1,0,0,5
0,0,0,2,0,6,0,6,0,7,0,0,0,0,0,0,0,0,0,4,0,0,0,0
0,1,0,1,0,0,0,0,0,0,0,1,2,1,0,0,0,5,0,0,0,0,0,1
1,0,0,1,0,0,0,0,0,4,0,0,1,0,0,0,0,0,1,1,0,1,1,0
0,0,0,0,0,0,0,0,0,5,4,0,0,0,0,1,1,1,0,0,0,0,6,0
0,0,7,0,1,1,0,1,0,0,0,0,0,6,0,0,1,0,0,0,0,0,0,0
0,0,0,6,2,1,0,0,0,0,0,0,5,0,0,0,0,1,6,0,0,1,2,1
0,0,0,1,0,1,4,0,6,0,0,0,0,1,1,0,0,0,0,0,0,1,1,0
