0,6,0,0,0,1,0,0,0,0,0,1,0,0,5,1,0,0,0,0,0,1,0,0
0,1,0,1,1,0,0,0,0,0,0,0,0,1,0,1,0,0,0,0,1,0,1,0
1,0,0,1,4,1,2,0,0,0,0,0,1,0,0,1,0,0,0,0,0,3,0,0
0,0,0,0,5,0,6,1,0,0,1,0,1,0,0,1,0,0,0,0,0,0,0,0
0,1,0,0,0,5,0,0,0,7,0,1,0,0,0,0,0,1,0,0,0,1,0,7
0,5,0,0,1,0,0,0,0,0,0,0,0,0,0,1,1,1,0,2,0,4,0,0
0,0,0,0,3,0,0,0,0,0,0,6,0,0,0,0,1,0,0,0,0,0,0,1
3,0,3,0,1,0,0,0,0,0,0,0,1,4,1,0,0,3,2,0,0,0,6,3
0,1,0,0,0,3,0,0,0,4,0,0,0,1,0,0,0,1,0,0,0,3,0,0
0,0,0,0,0,0,0,0,4,0,0,0,1,0,2,0,0,0,0,0,0,0,0,0
6,5,0,0,1,1,0,7,0,7,0,0,0,0,1,0,6,5,0,0,1,1,0,7
0,5,1,0,1,4,0,0,0,6,0,0,0,0,0,1,0,5,1,0,1,4,0,0
0,0,1,0,0,6,1,1,1,6,0,0,0,0,5,0,0,0,1,0,0,6,1,1
0,0,0,0,1,0,0,1,0,0,0,1,0,0,0,3,0,0,0,0,1,0,0,1
0,0,0,0,0,0,0,0,1,0,0,0,0,0,0,0,0,0,0,0,0,0,0,0
0,0,1,0,0,0,0,0,1,0,0,1,0,0,0,0,0,0,1,0,0,0,0,0
