0,1,1,0,0,0,3,0,0,0,0,4,0,2,0,1,0,0,0,0,0,3,1,0
3,0,0,1,0,0,0,0,0,6,0,0,4,1,0,0,0,1,0,0,1,1,0,3
0,0,0,0,6,0,0,0,2,1,0,0,0,0,1,5,3,1,0,1,1,6,1,0
0,1,0,0,0,0,0,0,0,0,0,0,0,1,0,0,0,1,3,0,1,1,0,1
0,1,1,5,0,0,0,0,3,2,0,6,0,0,0,0,1,1,0,7,0,0,1,1
0,0,0,0,0,0,0,1,0,1,0,0,0,0,0,0,0,6,0,0,0,1,0,0
0,0,0,0,0,0,7,0,1,0,0,0,0,0,0,0,0,6,0,1,5,1,1,0
1,4,0,0,1,0,0,1,0,0,0,0,0,0,0,0,0,0,1,0,4,1,0,0
1,0,1,0,0,2,0,0,5,0,0,4,0,0,1,0,0,0,0,5,1,0,1,1
6,0,1,5,0,0,0,0,0,6,0,0,0,0,0,0,0,1,0,1,1,0,0,1
0,1,5,0,0,1,0,0,4,1,0,1,0,0,0,6,0,1,1,0,0,0,0,3
6,0,0,1,0,1,0,0,4,1,1,0,0,0,1,0,0,0,6,0,0,6,5,1
1,1,0,3,1,1,0,0,0,3,0,4,4,0,1,0,4,0,0,7,0,5,0,0
1,1,1,0,1,1,0,1,0,1,0,0,5,0,0,0,0,0,0,0,4,0,0,0
0,1,0,0,0,0,0,1,0,1,1,5,1,1,0,0,0,0,1,1,0,0,1,1
0,1,1,1,0,6,0,1,0,0,0,0,0,0,0,0,0,0,0,4,5,0,0,0
