0,1,1,1,1,1,1,1,0,0,0,0,0,0,0,0,0,0,0,0,0,0,0,0,0,0,0,0,0,0,0,0,0,0,0,0,0,0,0,0,0,0,0,0,0,0,0,0
0,1,0,0,0,0,0,0,0,0,0,0,0,0,0,0,0,0,6,0,0,0,0,0,0,0,0,0,0,0,0,0,0,0,0,0,0,0,0,0,0,0,0,0,0,0,0,0
0,1,5,8,0,0,0,0,0,0,0,0,0,0,0,0,0,3,3,3,2,0,0,0,0,0,0,0,0,0,0,0,0,1,1,1,1,1,1,0,0,0,0,0,0,0,0,0
0,1,1,1,0,0,0,0,0,7,0,9,0,0,7,0,0,0,0,0,2,0,0,0,0,0,0,0,0,0,0,0,0,0,0,0,0,0,1,0,0,0,0,0,0,0,0,0
0,0,0,1,1,2,0,0,2,1,1,1,1,1,1,2,0,0,0,0,2,0,0,0,0,0,0,0,0,0,0,0,0,0,7,0,0,7,1,0,0,0,0,0,0,0,0,0
0,0,0,0,0,2,0,0,2,0,0,0,0,0,0,2,0,0,0,0,2,0,3,0,0,0,0,0,0,0,0,0,0,2,1,1,1,1,1,0,0,0,0,0,0,0,0,0
0,0,0,0,0,2,1,1,2,0,0,0,0,0,0,2,0,0,9,0,2,0,1,1,0,0,9,0,1,1,9,0,0,2,0,0,0,0,0,0,0,0,9,0,5,0,0,0
1,1,1,1,1,1,1,1,2,0,0,0,0,0,0,2,1,1,1,1,1,1,1,1,0,1,1,1,1,1,1,1,0,2,0,0,0,0,0,0,3,3,3,3,3,3,3,3