4,0,0,6,4,0,0,0,1,0,0,0,0,0,0,6,0,0,0,0,1,2,0,0
0,0,0,0,5,0,0,0,0,0,0,2,0,0,0,0,0,0,1,0,1,1,0,1
0,1,0,0,1,0,1,5,4,1,0,1,0,1,0,0,1,1,6,0,0,1,1,0
2,0,1,0,0,1,0,0,0,0,0,0,0,1,0,0,0,0,0,0,0,0,0,0
0,3,0,0,0,1,0,0,0,1,1,0,1,0,0,0,0,0,0,7,0,1,6,0
1,1,0,0,0,0,0,0,0,0,0,0,0,0,0,0,2,1,0,0,0,1,0,0
0,0,0,0,0,0,0,7,0,1,1,5,0,0,0,0,1,0,5,1,0,0,1,0
0,0,0,0,1,0,0,0,0,0,0,0,6,0,1,1,0,0,5,0,1,1,0,0
0,0,0,0,0,0,0,0,0,0,4,1,1,1,0,1,3,0,1,1,1,0,1,0
4,0,0,0,0,4,0,1,0,6,0,0,1,0,1,1,0,0,1,0,0,0,0,0
0,0,0,4,0,0,0,0,0,0,1,0,0,1,1,0,0,0,5,4,0,0,1,0
2,0,3,0,4,0,0,0,0,1,0,0,0,1,0,0,1,0,0,0,0,0,0,0
0,0,0,7,0,3,0,5,0,1,0,0,1,6,0,0,0,7,0,0,0,0,0,0
1,6,5,6,1,0,0,0,0,0,0,0,0,1,0,1,0,0,1,0,1,0,0,0
1,0,0,0,0,1,0,0,0,0,0,0,0,0,0,0,6,4,0,0,6,0,0,0
0,0,0,0,1,0,0,0,4,1,0,0,0,0,0,3,0,0,0,1,0,0,0,1
