0,1,0,5,0,0,0,0,6,0,0,0,1,0,0,0,0,0,1,0,5,1,0,0
0,0,0,1,1,6,0,1,1,0,0,0,0,1,0,5,0,0,0,2,1,0,1,0
1,1,1,0,0,0,0,0,1,0,5,0,0,0,0,1,0,6,0,0,0,1,0,0
0,0,0,0,7,0,0,0,1,0,0,0,2,0,0,0,4,0,0,0,0,0,2,0
6,1,0,0,0,0,1,0,1,0,0,1,0,7,0,0,0,5,1,0,2,0,1,0
0,0,0,1,1,2,1,0,1,0,0,0,0,0,0,0,4,0,0,7,0,0,0,0
5,1,3,1,0,0,0,0,0,0,4,0,3,1,0,0,0,1,0,0,0,0,0,4
0,0,3,1,0,0,0,0,0,2,6,4,0,0,0,0,0,0,0,0,1,0,2,0
0,3,0,0,0,0,0,0,4,0,1,0,1,4,0,5,1,1,0,0,0,6,1,0
0,0,0,1,0,0,0,0,5,0,1,0,0,0,0,0,0,1,1,0,0,2,0,0
1,0,5,0,0,0,0,4,0,0,0,7,0,0,0,0,0,0,0,0,0,0,1,0
6,0,0,0,1,0,0,0,1,0,2,0,0,0,0,0,0,3,0,0,0,0,0,0
1,0,1,1,0,0,2,1,1,0,6,0,0,0,0,0,0,0,0,0,0,0,0,0
0,0,1,0,0,0,0,1,0,0,1,0,1,1,0,3,6,0,0,0,0,0,0,0
1,0,0,1,0,0,0,0,1,0,0,0,5,0,0,0,0,0,0,6,7,0,4,6
0,0,0,0,0,1,0,0,2,0,2,1,1,0,0,0,0,0,0,0,0,0,4,5
