5,0,0,0,0,0,0,0,4,0,4,4,1,0,0,0,1,0,0,0,0,4,0,0
0,0,4,0,1,4,0,0,4,1,0,0,0,0,0,4,0,0,0,0,0,0,0,5
0,1,5,0,1,0,0,0,0,3,1,0,0,4,6,0,0,0,7,0,0,0,0,6
0,0,0,1,0,1,4,0,0,0,0,1,0,0,0,0,0,0,0,0,0,0,0,0
0,0,0,0,0,6,0,0,0,0,5,1,0,0,0,0,0,2,0,3,0,0,0,0
1,1,0,0,6,0,0,0,0,0,1,1,0,0,1,0,0,0,1,0,0,0,4,4
1,0,0,3,0,2,0,1,0,2,1,1,0,0,0,7,0,0,0,1,0,1,0,0
0,0,1,2,0,1,0,0,0,0,0,0,1,0,1,0,0,0,0,0,0,0,6,0
1,1,0,0,0,4,0,0,0,0,3,0,1,0,1,0,0,1,0,0,3,0,0,0
0,0,4,0,3,0,0,0,0,2,0,0,0,0,0,0,0,0,1,0,0,0,0,0
0,0,0,0,0,0,0,0,0,1,6,0,0,0,0,6,0,7,0,0,0,0,0,6
0,0,0,0,0,1,0,0,0,0,0,0,0,0,1,0,4,0,1,0,0,0,0,0
1,0,0,0,0,0,0,0,0,0,0,0,0,0,2,0,4,6,1,0,0,0,3,0
0,7,0,6,0,0,1,0,0,0,7,0,1,0,0,0,0,0,0,0,4,0,1,0
0,0,0,1,0,5,0,0,0,0,0,1,0,0,0,0,0,0,0,1,0,4,0,0
0,0,0,0,0,0,0,2,0,0,0,0,0,4,0,0,0,1,0,0,0,0,4,1
